W w w w w w w w w w w g w w w w w w w w w w
W g g g g g g w g g g g g g w g g g g g g w 
W g g g g g g w g g g g g g w g g g g g g w 
W g g g g g g w g g g g g g w g g g g g g w 
W g g g g g g w g g g g g g w g g g g g g w 
W g g g g g g w w w w w w w w g g g g g g w 
W g g g g g g g g g g g g g g g g g g g g w 
W w w w w w g w w w w g w w w g w w w w w w 
W g g g g w g w g g g g g g w g w g g g g w 
W g g g g w g w g w w g w g w g w g g g g w 
g g g g g w g g g g g g w g w g w g g g g w 
W g g g g w g w g w g g g g g g w g g g g g 
W g g g g w g w g w g w w g w g w g g g g w 
W g g g g w g w g g g g g g w g w g g g g w 
W w w w w w g w w w g w w w w g w w w w w w 
W g g g g g g g g g g g g g g g g g g g g w 
W g g g g g g w w w w g w w w g g g g g g w 
W g g g g g g w g g g g g g w g g g g g g w 
W g g g g g g w g g g g g g w g g g g g g w 
W g g g g g g w g g g g g g w g g g g g g w 
W g g g g g g w g g g g g g w g g g g g g w 
W w w w w w w w w w g w w w w w w w w w w w 
 
